------34
------43
------34
------43
------34
------43
------34
------43
--1---34
--1---43
1101--34