???????????----1
???????????---55
???????????---34
???????????---23
???????????--101
???????????-1101